q------------------------------e
|x0x0x0x0x0x0xPx0x0x0x0x0x0x0x0|
|0x0x0x0x0x0x0xxxx0x0x0x0x0x0x0|
|x----------------------------x|
|0x0x0x0x0x0x0xxxx0x0x0x0x0x0x0|
|-------x--------------x-------|
|0x0x0x0x0x0x0xxxx0x0x0x0x0x0x0|
|--------------xx--------------|
|x0x0x0x0x0x0x0x0x0x0x0x0x0x0x0|
|xq--e0q----cxxxxxxz----e0q--ex|
|x|0xz-c0x0x0x0x0x0x0x0xz-cx0|x|
|0ze0x0xx0x0x0x0x0x0x0x0x0x0qc0|
|x0|x0x0xq--ex----xq--ex0x0x|0x|
||xz----x|x0|xxBBxx|0x|xq---cx||
||0x0x0x0|0x|xxBBxx|x0|0x0x0x0||
|z-----xxxxxz------cxxxxx-----c|
|0x0x0x0x0x0x0xxxx0x0x0x0x0x0x0|
|-------x--------------x-------|
|0x0x0x0x0x0x0xxxx0x0x0x0x0x0x0|
|x----------------------------x|
|0x0x0x0x0x0x0xxxx0x0x0x0x0x0x0|
|--------------xx--------------|
|0x0x0x0x0x0x0xxxx0x0x0x0x0x0x0|
z------------------------------c

